10
10
##########
#  a     #
#        #
#   ##   #
#        #
#     b  #
# c   #  #
#        #
#  #  d  #
##########