10
10
##########
#  a   n #
#        #
#   ##   #
#  l     #
#     b  #
# c   #  #
#        #
#  #  d  #
##########